Строкові методи
capitalize()	Перетворює перший символ у верхній регістр
casefold()	    Перетворює рядок у нижній регістр
center()	    Повертає відцентрований рядок
count()	        Повертає кількість разів, коли вказане значення зустрічається в рядку
encode()	    Повертає закодовану версію рядка
endswith()	    Повертає true, якщо рядок закінчується вказаним значенням
expandtabs()	Встановлює розмір табуляції рядка
find()	        Шукає в рядку вказане значення та повертає позицію, де його було знайдено
format()	    Форматує вказані значення в рядку
index()	        Шукає в рядку вказане значення та повертає позицію, де його було знайдено
isalnum()	    Повертає True, якщо всі символи в рядку є буквено-цифровими
isalpha()	    Повертає True, якщо всі символи в рядку містяться в алфавіті
isascii()	    Повертає True, якщо всі символи в рядку є символами ascii
isdecimal()	    Повертає True, якщо всі символи в рядку є десятковими
isdigit()	    Повертає True, якщо всі символи в рядку є цифрами
isidentifier()	Повертає True, якщо рядок є ідентифікатором
islower()	    Повертає True, якщо всі символи в рядку написані в нижньому регістрі
isnumeric()	    Повертає True, якщо всі символи в рядку є числовими
isprintable()	Повертає True, якщо всі символи в рядку можна друкувати
isspace()	    Повертає True, якщо всі символи в рядку є пробілами
istitle()	    Повертає True, якщо рядок відповідає правилам заголовка
isupper()	    Повертає True, якщо всі символи в рядку є верхніми
join()	        Перетворює елементи ітерації в рядок
ljust()	        Повертає вирівняну по лівому краю версію рядка
lower()	        Перетворює рядок у нижній регістр
lstrip()	    Повертає ліву обрізану версію рядка
maketrans()	    Повертає таблицю перекладів для використання в перекладах
partition()	    Повертає кортеж, де рядок поділено на три частини
replace()	    Повертає рядок, де вказане значення замінено вказаним значенням
rfind()	        Шукає в рядку вказане значення та повертає останню позицію, де його було знайдено
rindex()	    Шукає в рядку вказане значення та повертає останню позицію, де його було знайдено
rjust()	        Повертає вирівняну по правому краю версію рядка
rpartition()	Повертає кортеж, де рядок поділено на три частини
rsplit()	    Розбиває рядок за вказаним роздільником і повертає список
rstrip()	    Повертає праву обрізану версію рядка
split()	        Розбиває рядок за вказаним роздільником і повертає список
splitlines()	Розбиває рядок на розриви рядків і повертає список
startswith()	Повертає true, якщо рядок починається з вказаного значенняe
strip()	        Повертає обрізану версію рядка
swapcase()	    Поміняється місцями, нижній регістр стає верхнім і навпаки
title()	        Перетворює перший символ кожного слова у верхній регістр
translate()	    Повертає перекладений рядок
upper()	        Перетворює рядок у верхній регістр
zfill()	        Заповнює рядок вказаною кількістю 0 значень на початку

Створення словника
dict = {"key":"value"}
---------------------------
arr1 = [1, 2, 3]
arr2 = ["a", "b", "c"]
dict = zip(arr1, arr2)
--------------------------
Dict = dict([(1, 'One'), (2, 'Two')])


Ключове слово nonlocal
Ключове слово nonlocal використовується для роботи зі змінними всередині вкладених функцій, де змінна не повинна належати внутрішній функції.

Використовуйте ключове слово nonlocal, щоб оголосити, що змінна не є локальною.

Функція reduce

Функція reduce(fun,seq) використовується для застосування певної функції, переданої в її аргументі, до всіх елементів списку, згаданих у переданій послідовності.

модуль random

Модуль містить функції для створення псевдо-випадкових чисел

seed()	            Ініціалізуйте генератор випадкових чисел
getstate()	        Повертає поточний внутрішній стан генератора випадкових чисел
setstate()	        Відновлює внутрішній стан генератора випадкових чисел
getrandbits()	    Повертає число, що представляє випадкові біти
randrange()	        Повертає випадкове число між заданим діапазоном
randint()	        Повертає випадкове число між заданим діапазоном
choice()	        Повертає випадковий елемент із заданої послідовності
choices()	        Повертає список із випадковим вибором із заданої послідовності
shuffle()	        Бере послідовність і повертає послідовність у випадковому порядку
sample()	        Повертає заданий зразок послідовності
random()	        Повертає випадкове число з плаваючою точкою від 0 до 1
uniform()	        Повертає випадкове число з плавкою між двома заданими параметрами
triangular()	    Повертає випадкове число з плаваючою точкою між двома заданими параметрами. Ви також можете встановити параметр режиму, щоб вказати середину між двома іншими параметрами
betavariate()	    Повертає випадкове число з плаваючою точкою від 0 до 1 на основі бета-розподілу
expovariate()	    Повертає випадкове число з плаваючою точкою на основі експоненційного розподілу
gammavariate()	    Повертає випадкове число з плаваючою точкою на основі гамма-розподілу
gauss()	            Повертає випадкове число з плаваючою можливістю на основі розподілу Гаусса
lognormvariate()	Повертає випадкове число з плавкою на основі логарифмічного нормального розподілу
normalvariate()	    Повертає випадкове число з плавкою на основі нормального розподілу
vonmisesvariate()	Повертає випадкове число з плаваючою точкою на основі розподілу фон Мізеса
paretovariate()	    Повертає випадкове число з плавкою на основі розподілу Парето
weibullvariate()	Повертає випадкове число з плаваючою можливістю на основі розподілу Вейбулла